听力笔记
填空题：
1、注意联想应该填写哪种类型的合适词汇,有助于避免听对了后填写错误
2、填空题不好定位预判和联想，就一定要看题目所给的前后连接原词▲
3、填空题如果预判是名词，提前提醒自己注意是否是复数！
4. teen和ty的区别,比如115和150仔细
5. 复数还是仔细
6. 24 April 而不是 April 24

选择题：
1、顺序仔细读题，理解意思后只划出关键词和题目方向（沉下心来仔细读题，不慌张）
2、看清楚题目问的是什么(firstly-initially)(complex via-综合大楼)
3、将大多数的时间拿来读题和选项，看清楚和理解懂题目的意思再做题！！！！听的时候就认真理解内容！！！！
4、选择题的选项可能直接是多个"方向"的回答▲▲，注意关键词的分别即可选择，例如：time、theoretical等等
5. 标记【话题词】- 标记题干中的问题方向【关键词】- 标记选项中的关键内容【适当联想】 - 不要什么词都标记，就标记Keyword！

匹配题:
1、看题目和加粗黑字的提示, notes记录选项的关键词, 在听的时候抓表达意思的方向, 然后直接选

地图题关键词:rear-后部，bend-拐弯处，corner-角落











dissertation module - 论文课程
seed germination - 种子发芽
thorough - adj.仔细的, 仔细的, 完全的, 彻头彻尾的;完全的;十足的
crow - n.乌鸦
customised itineraries - 定制行程
calibre - n.才干，能力;(枪、炮的) 口径
asthma - n.哮喘
industrious - adj.勤劳的 勤奋的
tome - n.巨著, 大部头书








formalities - 礼节，手续
interface - 界面
interactive - 互动性
bonus - 奖金，红利
fertilizer - 肥料
sliver - 棉条
silver - 银子
isolation - n.隔绝，孤立;孤独
initiation - n.入会，加入;创始，发起
simulation - n.模仿，模拟，仿真
insulation - n.隔热，绝缘，隔音(材料)
apparently - adv.据说;看来，显然
currently - adv.目前，当前
flourish - vi.繁荣，兴旺;茁壮成长
nourish - vt.给…提供营养;培养，助长
vernacular - n.土语，本地语 民间建筑风格 / adj.土语的 具有某一群体风格的
vet - n:兽医 退伍军人 兽医诊所 仔细检查 / vt.调查，审查
confer - vt.授予，赋予
defer - vt.推迟，延缓
refer - vi.提及;指，关于;参考，查阅
infer - vt.(根据已有信息)推断;暗示
census - n.官方统计，人口普查
consensus - n.一致看法，共识
flourish - vi.繁荣，兴旺;茁壮成长
thrive - vi.兴旺，繁荣，欣欣向荣
vote - vt.vi.投票，表决，选举
vet - n.兽医 退伍军人 兽医诊所 / vt.调查，审查 仔细检查
deem - vt.认为，视为，相信
reckon - vt. vi.想，认为
muddle - n.糊涂，困惑;一团糟
hurdle - n.障碍，难关;跳栏;跨栏赛跑
jumble - n.杂乱的一堆;供义卖的废旧物品 / vt.vi.(使) 变得杂乱，(使) 变得混乱
insist - vt.vi.坚持，坚决要求;坚称
resist - vt.vi.按捺，克制;抵抗，抵制;抵御
preserve - vt.维护，保护;保持;保存(食物)
conserve - vt.节约，节省;保护，保存
slide - vi. vt.(使) 滑行;悄悄移动
glide - vi.滑行，滑动;滑翔
practically - adv.几乎，差不多;实际上，实践上
virtually - adv.几乎，实际上;虚拟地
plead - vi.vt.恳求，央求;认罪，申辩;声援
pledge - n.保证，诺言，承诺;抵押品
confirm - vt.证实，证明;确认(安排);批准
conform - vi.遵守 顺应大流 相一致
exacerbate - vt.使恶化，使加剧
exaggerate - vi.vt.夸张，夸大
aggravate - vt.加重，使恶化 激怒，使恼火
magnify - vt.放大;使(问题等)加重;夸大
blast - n.爆炸，气浪;强劲的气流;响声
boast - vi.vt.自吹自擂，自夸 / vt.有(值得自豪的事物) / n.自吹自擂，自夸
prompt - vt.促使;引起，激起;提示
domestic - adi.国内的;家庭的;家养的
dynamic - adj.充满活力的 动态的 / n.动态 力学，动力学
avenue - n.街道 林荫大道 方法，途径
revenue - n.收入，财政收入，税收
clarity - n.(表达) 清楚;(思路，图像) 清晰
clarify - vt.阐明，阐释
intricate - adj.错综复杂的
indicate - v.标示;表明;显示;暗示
intrinsic - adj.本质的，内在的，固有的
assume - vt.假设;承担，取得;呈现出;假装
presume - vi.vt.推测，猜测
resume - vt. vi.(中断后) 继续
consume - vt.消耗，耗费;吃，喝;使充满…
cock - n.公鸡
cork - n.软木塞;软木
cowk - v.干呕，恶心
dispute - n.争论，争端 / vt.对…表示异议，对…表示质疑 / vt.vi.就…争论，就…争执
controversy - n.争论，争议
invaluable - adj.非常宝贵的，极为有用的
onwards - adv.从(某时)起一直;向前，前往
forth - adv.(从某时)往前，(从某处)向外
enquire - vi.vt.询问，打听
enquiry - n.询问，打听;调查，探究
ornament - n.装饰品;首饰，饰物;点缀
gadget - n.小器具，小装置，精巧的小玩意
trinket - n.廉价首饰，小装饰物
expire - vi.(协议等)到期，失效;死亡
equator - n.赤道(equatorial - adj.赤道的)
tropical - adj.热带的
sensation - n.知觉，感觉能力;直觉;轰动
sanction - n.制裁;许可，批准;处罚
sanctuary - n.禁猎区;避难;庇护所;圣殿
compatible - adj.兼容的;可共存的;合得来的
dauntless - adj.无所畏惧的
cargo - n.(轮船、飞机所装载的)货物
freight - n.货物，货运 运费 / vt.(用飞机等)运送，托运
coarse - adj.粗糙的;大颗粒的;粗鲁的
curse - n.骂人的话，咒语，祸根
pliable - adj.易弯的，柔韧的 (人)易受影响的
aggressive - adj.好斗的，有侵略性的;进取的
subsidy - n.补贴，津贴
subsidiary - adj.辅助的，次要的 / n.(公司) 附属的子公司，附属公司
badge - n.徽章;(制服上的) 标记;象征
bandage - n.绷带
foam - n.泡沫橡胶;泡沫;泡沫剂
loam - n.壤土，沃土，肥土
roam - vi.vt.闲逛，漫步;打量
crew - n.(全体)船员，机组人员;专业团队
screw - n.螺丝，螺丝钉;螺旋桨;狱警
shrewd - adj.精明的，敏锐的
strew - vt.撒，在…上布满(或撒满)
prerequisite - n.先决条件，前提
requisite - adj.必备的，必需的
premise - n.前提;房屋及土地，经营场所
postpone - vt.推迟，延缓
substitute - n.代替者，代替物;替补运动员
comprise - vt.包括，由…组成;构成，组成
bulb - n.灯泡，电灯泡 球茎，鳞茎
bulk - n.大部分;大体积，大量
consignment - n.运送的货物;运送，寄售
assignment - n.作业，任务;(任务等的)分配
laboratory - n.实验室，实验楼
lavatory - n.厕所，洗手间
tilt - vi.vt.(使)倾斜;使倾向于，偏向
silt - n.淤泥，(沉积的)泥沙 / vi. 淤塞
latent adj.潜在的，潜藏的
patent - n.专利权
tenant - n.房客，租户
slum - n.贫民窟，贫民区 / vi.体验贫苦生活
slim - adj.苗条的;单薄的;微小的
slam - vi.vt.(使…)砰地关上
literary - adj.文学的;从事写作的
literacy - n.识字，读写能力
antidote - n.解药，解毒剂;矫正方法
anecdote - n.轶事，趣闻
necessarily - adv.必然地，不可避免地，必定地
inevitably - adv.不可避免地，必然地
interrupt - vi.vt.打断，打扰 / vt.使中断，使暂停;遮挡，阻断
disrupt - vt.使中断，扰乱
account - n.账户; 账目; 叙述; 解释, 说明
amount - n.数量 共计 / vi.金额 等同于 发展成
terrain - n.地形，地势，地带
terrace - n.露台;梯田;排屋;阶梯看台





























同义替换：
Problems=difficult





=================================================哈利波特=================================================
Sorcerer's Stone - 魔法石
blasted - 该死的
bloody letter
miserable - 恶心的
prune - 混蛋
middle - 小肚皮
wizard - 巫师
aggrieve - vt.使悲伤，使受屈;侵害
aggrieved - adj.愤愤不平的;受害方的
vermin - 害虫
phoenix - 凤凰
flaw - n.瑕疵，缺点;错误;性格缺陷
invisibility cloak - 隐形斗篷
adventure - 冒险
Let's not wait for the grass to grow - 我等的花儿都谢了
Sirius - 天狼星
swim in the deepest ocean or glide over the highest cloud - 在深海里遨游，在空中翱翔



-------------------------------------Nature deep learning review thesis-------------------------------------

computational models - 计算模型
processing layers - 处理层
representations of data - 数据表示
levels of abstraction - 抽象级别
state-of-the-art - 最先进的
speech recognition - 语音识别
visual object recognition - 视觉对象识别
object detection - 对象检测
domains - 领域
communities - 界
backpropagation algorithm - 反向传播算法
convolutional neural network - 卷积神经网络
recurrent neural network - 递归神经网络（循环神经网络）
images,video,speech,audio - 图像，视频，语音，音频
sequential data - 连续性数据（顺序性数据）
web searches - 网络搜索
content filtering on social networks - 社交网络的内容过滤
e-commerce websites - 电子商务网站
consumer products - 消费产品
identify objects - 识别物体 
natural data in their raw form - 原始形式的自然数据
careful engineering and considerable domain expertise - 精心的工程设计和大量的领域专业知识
feature extractor - 特征提取器
pixel values - 像素值
learning subsystem - 学习子系统
detect or classify - 检测或分类
transformations - 转换
classification tasks - 分类任务
for discrimination - 为了辨别
amplify - 放大
presence or absence of edges - 是否存在边缘
particular orientations and locations - 特定方向和位置
detects motifs - 检测图案
general-purpose learning procedure - 通用目标学习程序
making major advances - 获得重大进展
discovering intricate structure in high-dimensional data - 发现高维数据中的复杂结构
predicting the activity of potential drug molecules - 预测潜在药物分子的活性
particle accelerator - 粒子加速器
reconstructing brain circuits - 重建大脑回路
mutation - n.突变
extremely promising results - 非常有前景的成果
natural language understanding - 自然语言理解
sentiment analysis - 情感分析
in the near future - 在不久的未来
algorithms and architectures - 算法和架构
object/objective function - 目标函数
modifies its internal adjustable parameters - 修改内部可调参数
knobs - 旋钮
labelled examples - 标签示例
stochastic gradient descent (SGD) - 随机梯度下降
generalization ability - 泛化能力
half-spaces separated by a hyperplane - 由超平面分隔的半空间
position, orientation or illumination of an object - 物体的位置、方向或光照变化
pitch or accent of speech - 语音的音调或口音
linearly separate - 线性分离
distort space - 扭曲空间
The chain rule of derivatives - 导数的链式法则
oriented edge detectors - 定向边缘检测器
the latter two - 后两者(latter - 后者)
shallow - adj.浅的，不深的 肤浅的，刻薄的
invariance dilemma - 不变性难题
generic non-linear features - 通用的非线性特征
mappings - 映射
As it turns out, - 事实证明
with respect to - 关于
rectified linear unit - 线性整流函数（RELU）
largely forsaken by xxx - 很大程度上被xxx所抛弃
Regardless of - 无论
theoretical and empirical results - 理论和实证结果
saddle points - 鞍点
detecting pedestrians - 检测行人
handwritten digits - 手写数字
fast graphics processing units (GPUs) - 快速图形处理器
the advent of xxx - xxx的出现
map short temporal windows of coefficient - 提取短时间系数窗口
extracted from xxx - 从xxx提取/抽出
fragments of speech - 语音片段
deployed in - 部署在
overfitting - 过拟合
been rehabilitated - 被修复
audio spectrograms - 音频频谱
volumetric images - 体积图像
local connections - 局部连接
feature map - 特征图谱
discrete convolution - 离散卷积
semantically similar features - 语义相似的特征
coarse-graining - 粗粒度
exploit the property - 利用了特性
compositional hierarchies - 组成层次
classic notions - 经典理念
visual neuroscience - 视觉神经科学
trained jointly with xxx - 与xxx联合训练
probabilistic model - 概率模型
implemented language constraints - 实现语言限制
optical character - 光学字符
detection, segmentation and recognition - 检测,分割与识别
relatively abundant - 相对丰富
autonomous mobile robots - 自主移动机器人
regularization technique - 正则化技术
progress in hardware, software and algorithm parallelization - 硬件、软件和算法并行化方面的进步
field-programmable gate arrays - 可编程门阵列
chips - 芯片
exponential advantages - 指数优势
underlying data-generating distribution - 底层数据生成分布
componential structure - 组成结构
distributed representations - 分布式表征
binary - 二进制
semantic features - 语义特征
text corpus - 语料库
paradigms - 范式
judiciously chosen rules - 明智选择的规则
fast ‘intuitive’ inference - 快速的直观推理
underpins effortless commonsense reasoning -  支持毫不费力的常识推理
frequencies of occurrences - 出现频率
xxx has proved to be problematic - 被证明是一个难题
one word at a time - 逐字阅读
naive - n.天真 / adj.无知
There has been a surge of interest in xxx - 对xxx的兴趣大增
accumulator - 累加器/蓄能器/电瓶
acoustics - 声学
memory module - 内存模块
had a catalytic effect in reviving interest in xxx - 对唤起xxx的兴趣起到了催化剂的作用
high-resolution fovea - 高分辨率的眼窝
reinforcement learning - 强化学习
Neural Turing Machine - 神经图灵机
Long Short-Term Memory - 长短期记忆网络（LSTM）
algorithm principle - 算法原理
algorithm application - 算法应用
